11111111111
10000000001
10010000001
10000000001
100N0000001
10111000001
11111111111