11111111111
100000000011111
100000000000001
100000000011111
100N0000001
10111000001
10000000001
10000000001
10000000001
10000000001
10111000001
11111111111