NO     ./assets/north_wall.xpm
SO    ./assets/south_wall.xpm
WE ./assets/west_wall.xpm
EA ./assets/east_wall.xpm

F 0,255,0
C 255,255,255

        1111111111111111111111111
        1000000000110000000000001
        1011000001110000000000001
        10010000000000000000000011
111111111011000001110000000000001
100000000011000001110111111111111
11110111111111011100000010001
11110111111111011101010010001
11000000110101011100000010001
10000000000000001100000010001
10000000W00000001101010010001
1100000111010101111101111000111
11110111 1110101 101111010001
11111111 1111111 111111111111